+----------------------------------------+
|                                        |
|     +   +----------------+--------+    |
|  +  |   |                +        |    |
|  |  |   |         +               |    |
|  |  |   |   +-----+----------+    |    |
|  |  |   |   |                |    |    |
|  |  |   |   |    +------+    |    |    |
|  |  |   |   +----+      |    +----+    |
|  |  |   |   |    |      |    |    +    |
+--+  |   |   |    |  +   |    +         |
|     |   |   |    |  |   |              |
|     |   |   |    |  |   |              |
|     |   |   |    |  |   ++  ++----+----+
|  +  |   |   |    |  |   |    |    |    |
|  |  |   |   |    |  |   |    |    |    |
|  +--+   |   |    |  |   |    |    |    |
|  |      |   |    |  |   |    +----+    |
|  |      |   |    |  +---+              |
|  |   +--+   |    +      +-----+  +-+---+
|  |   |      |                      |   |
|  |   | ++---+    +    +---------+  |   |
|  |   |  |        |    |            |   |
|  +   |  |  +-----++   +------+-----+   |
|      |  |  | X    |          |     |   |
+--+   |  +  +---+  |          |     |   |
|  +   +            |    +-----+     |   |
|         +---------+                |   |
+------------------------------------+---+
